NO ./textures/001_height_0.xpm
SO ./textures/003_basecolor_0.xpm
WE ./textures/purplestone.xpm
EA ./textures/redbrick.xpm

C 200,200,200
F 10,10,10



111111111111111111111111111111111111111111111111111111111111111111111111111
100000000011000000000000110000000001100000000000011000000000110000000000001
101100000111000000000000000000000001100000000000011000000000110000000000001
100100000000000000000000000000000000110000000000001100000000011000000000001
101100000111000000000000110000000001100000000000000000000000110000000000001
100000000011000001110111110000000001100000000000000000000000110000000000001
10000000000000000000N111110000000000000000000000011000000000110000000000001
111111111111111111111111110000000001100000000000011000000000000000000000001
                         11111111111111111111111111000000000111111111111111
111111111111111111111111111111111111111111111111111100000001111111111111111
100000000011000000000000110000000001100000000000011000000000110000000000001
101100000111000000000000000000000001100000000000011000000000110000000000001
100100000000000000000000000000000001100000000000011000000000110000000000001
101100000111000000000000110000000001100000000000000000000000110000000000001
100000000011000001110111110000000001100000000000000000000000110000000000001
100000000000000000000111110000000000000000000000001100000000011000000000001
111111111111111111111111110000000001100000000000011000000000000000000000001
                         10000000000000000000000000000000000000000000000001
                         11000000000000000000000000000000000000000000000001
                        111111111111111111111111111111111111111111111111111
