NO ./textures/mossy.xpm
SO ./textures/eagle.xpm
WE ./textures/colorstone.xpm
EA ./textures/bluestone.xpm

F 200,200,255
C 50,200,210





        1111111111111111111111111
        1000000000110000000000001
        1011000001110000000000001
        100100000D00000000Z000001
111111111D11000001110000000000001
10000000001100000111011111D111111
1111D11111111101110000001000Z1
111101111111110111010100100Z01
11000000110101Z111000000D0Z001
1000000000000000D00000001Z0001
100000000000000011010100100001
11000001110101011111011100N011
11110111 1110101   11110010001
11111111 1111111  111111111111
